#domain
hospital
#levelname
MAPF03
#colors
blue: 0,A,B,C
#initial
++++++++++
+0    A  +
+     ++++
+        +
+  B  ++ +
+C     + +
++++++++++
#goal
++++++++++
+        +
+     ++++
+        +
+     ++ +
+      +0+
++++++++++
#end
