#domain
hospital
#levelname
SAD0
#colors
blue: 0, A
#initial
++++++++++
+0      A+
+     ++++
+        +
+     ++ +
+      + +
++++++++++
#goal
++++++++++
+0       +
+     ++++
+        +
+     ++ +
+      +A+
++++++++++
#end
